########
#@ #g ##
## ## g#
#g W  ##
## #####
#g    A#
########